3333333333
3000020013
3202002023
4000200003
3333333333
