3333333333
3000020001
3202002023
0000200003
3333333333
