3333333333
0030000003
3030203303
3000003003
3333333133
