3333333333
4030000003
3030203303
3000003103
3333333333
