3333333433
3000000003
3102000003
3000000003
3333333333
