3333333033
3000000003
1002000003
3000000003
3333333333
